###R####################### ############
### ######## ############## ############
### ######## ############## ############
### ######## ############## ############
### ######## ############## ############
### ######## ############## ############
### ######## ############## ############
### ######## ############## ############
### ######## ############## ############
###                                    #
### ## #################### ########## #
### ## #################### ########## #
### ## #################### ########## #
### ## #################### ########## #
### ## #################### ########## #
### ## #################### ########## #
### ## #################### ########## #
### #                       ########## #
### ################################## #
### #Q                                 #
### ################################## #
### ################################## #
###                                    #
### ####################################