#############
##R        ##
## ####### Q#
## ####### ##
##         ##
#############