............
. .       ..
.R.  ...  ..
. .... .  ..
.      ..  .
.       .  .
.   .   .Q .
.   .      .
. ... .... .
.        . .
.....      .
............