########
##R#####
## ##Q##
## ## ##
##    ##
########